##########################
#-............1.......1.1#
#.1222022.1.122.10000.1.1###
#.1.?.1...1.1...1...1*1.120#
#.1.1.3.120.3.1.1.1.322.1.1#
#.1.1...1.1...1.1.1.....1.1#
#.1.12222.32222.1.1222222.1#
#.1.1...........1.1.......1#
#.1.1.32222222220.1.320.320#
#.1.1.......1...1.1...1...1#
#.1.3222020.1.1.1.120.320.1#
#.1.....1.1.1.1.1.1.1...1.1#
#.32220.1.3.322.1...320.1.1#
#.....1.1.......1.1...1.1.1#
#222222.1222022.1.320.3.1.1#
#.......1...1...1...1...1.1#
#.32220.1.1.3222220.1.122.1#
#.....1.1.1......+1.1.1...1#
#.100.322.10000.322.1.1.100#
#.100.....10000.....1.1.1###
#.100000000000000000000@1#
########################## 
