###############
#....?........#
#.100.1022222.#
#.322.10......#
#.....10.1000.#
#.100.10...1*.#
#.322.3222.32.#
#.............#
#.1.3.32222222#
#.1...........#
#.322222.3222.@
#.............#
###############