##################################
#.1...1.........................+#
#.1.1.3.1.322222220.122222222220.#
#.1.1?..1........-1.1.........*1.#
#.1.1.1.1.1000000.1.1.12200.10.1.#
#.1.1.1.1.3222222.3.1.1..32.32.1.#
#.1.1.1.1...........1.1........1.#
#.1.1.1.1.1222222.1.1.3222222222.#
#.1.1.1.1.1.......1.1............#
#.1.1.1.1.1222220.1.3222222222222#
#.1.3.1.1.1.....1.1..............#
#.3...1.1.1.122.1.12222200222220.#
#...1.1.1.1.1...1.1.....10.....1.#
#.100.1.1.1.32222.1.120.10.120.1.#
#.322.100.1.......1.1.3.10.3.1.1.#
#.....100.322220200.1...10...1.1.#
#.3222222......3@32.3222222222.3.#
#.........1000..................+#
##################################
