######################
#00000020000000000000#
#022222.3220222200000#
#0...?.....1....10000#
#0.1000.1000.10.32220#
#002222.3222.10....+1#
#00..........10.32220#
#00.1..10000.10.....1#
#02.3202*1.32222220.1#
#2....1..1........1.1#
#..1202.1202220.122.1#
#0.3.1..1.1...1.1...1#
#0...1.10.322.1.1.120#
#00222.10.....1.1.3.1#
#00....10.100.1.1...1#
#00000.32.10000.1.1.1#
#00222...+32222.3.120#
#02....1..........1.1#
#0..1222.120.322202.1#
#00.1....3.1.....3..1#
#00.1.10...320.1..+10#
#00.1.3000...1.30.320#
#00.1..122.1.1..1..@1#
#0..10.1...1.10.1.100#
#00000000000000000000#
######################
