###################
#000.....1...3.322#
#000.322.3.32.....#
#00?..........120.#
#00.1.1.1.1.1.1.3.#
#00.1.1.1.1.1.1...#
#00.1.1...1.1.3222#
#00.1.1.1.1.1.....#
#...3.3.3.3.10....#
#.1.........10....#
#.10000.1.10000...#
#.1...1.1.1...100.#
#.1.1.1.1.1.1.320.#
#.1.1.1.1.1*1...1.#
#.1.322.1.322.1.1.#
#.1.....1.....1.1.#
#.1200.100.1000.1.#
#.1.32.322.3222.1.#
#.1.............1.#
#.122222222222222.#
#.1...............#
#.100000000000000.#
#.322222222222222.#
#.................#
#0000000000000000.#
#0022222222222222.#
#00@..............#
################### 
