######################
#0?32..12022222220-1.#
#0....10.1.......1.1.#
#0200.32.1.32200.1.1.#
#2.32....1....32.1.1.#
#.....10.1..1....1.1.#
#.10.100.1.32.10.1.1.#
#.10.1...3....32.3.3.#
#.10.320............+#
#.10...100.32220.1.10#
#.3200.122.....1.1.10#
#...10.1...100.1.1.10#
#.3220.100.100.1.1.10#
#....1.322.320.1.1.10#
#.1.10....-..1.1.1.10#
#.1.10.120.1.1.3.1000#
#.1.10.3.1.1.1...10.@#
#222222..1.1.1.1000.1#
#.......10.1.1.3200.1#
#.12220.32.1.1...10.1#
#.1...1....1.100.10.1#
#.1.1.1020.1.320.10.1#
#.1.1.10.1.1...1.10.1#
#.1.1.32.1.1.120.10.1#
#.1.1....1.1.1.1.10.1#
#.1.3000.1.1.1.1.32.1#
#.1..100.322.1.1....1#
#.10.100.....1.100000#
#.32.302.1.322.322222#
#....+1*.1...........#
######################

