#######################
#222...3222222.3220..*#
#...?1............1.1.#
#22222.1222..32.1.1.1.#
#......1........1.1.3.#
#22....1.32220..1.1...#
#.....12.....1..1.1.30#
#0.0222.3220.1..1.1..1#
#2.1.......3.1000.32.1#
#..1.@100....1000....1#
#######################
