##########################
#02202220.....-1022002020#
#0..1?..1.1000.10..10.1*1#
#20.122.1.3222.32.100.3.1#
#.1.1...1.........100...1#
#.1.1.100.1220.100000.100#
#.3.3.322.1..1.322222.300#
#........+32.1........+10#
#0.100.1.....1.12220.1.10#
#0.320.1.32220.1...1.1..1#
#0...1.1.....1.1.1.1.3222#
#0.122.1.300.1.1.100.....#
#..1...1..1000.1.1222220.#
#022.1.1..1020.1.1.....1.#
#0...1.32.32.1.3.32220.1.#
#22222.......1.......1.1.#
#......12222.122222..1.1.#
#000.322.....1......32.1.#
#000@....1000000000....1.#
##########################

